tabs -> cx_jxxlcsms
playbtn -> cx_wrmlwxvm
stui-page -> cx_mnxdfpcx
stui-pannel__head -> cx_bohtsjby
jpg -> cx_valfjikc
stui-news-nav -> cx_plxcxuic
more -> cx_abhldvdy
stui-content__detail -> cx_oybzwwzg
pagenow -> cx_tyxbsdhm
stui-page-text -> cx_lixrnxvx
stui-mobile__shere -> cx_ysmrvhlf
stui-gbook-form -> cx_ikqapxnc
submit -> cx_xdqxifcw
stui-screen__list -> cx_yrsuywei
num -> cx_amdjpjng
stui-pannel__nav -> cx_csbabxth
stui-content__playlist -> cx_waqdyouo
stui-header__menu -> cx_veehgoye
pic-text -> cx_fderntdm
autocomplete-suggestions -> cx_jutpzmys
visible-mi -> cx_wrrqosjd
score -> cx_ahhqwqpf
stui-foot -> cx_ebluvmsz
item -> cx_lvqqvehn
mobile-share -> cx_rijnjmku
code -> cx_keqmtjia
gif -> cx_fiukilpe
cn -> cx_xxyrdliy
hidden-md -> cx_ogbhwydj
js -> cx_ehhnijrj
gray -> cx_zypayqpx
flickity-prev-next-button -> cx_owccmdwe
stui-content__intro -> cx_hdfuxich
text-ccc -> cx_phxwqroa
stui-content__downlist -> cx_kkruobek
stui-pannel-side -> cx_kmsmlwsc
icon_code -> cx_yftcpmmd
index -> cx_qjvcrogw
tab-content -> cx_iecicdtl
visible-lg -> cx_nuuerzsa
screen-hide -> cx_zgpchvkw
dropdown-menu -> cx_iexyzspp
visible-sm -> cx_lrztiidp
data -> cx_qesffrss
gules -> cx_nyfrowpb
stui-player__detail -> cx_cazmxhjh
cut -> cx_pxkwrzju
clearfix -> cx_xzwoevcx
flickity-viewport -> cx_nevefxsw
icon_color -> cx_snogbxmc
green -> cx_iwuitimt
tab-pane -> cx_zpiowxdj
is-selected -> cx_oiwckhjk
table-text -> cx_nlizwtoe
top-fixed -> cx_qamaadpc
hidden-lg -> cx_mecvhyib
padding-0 -> cx_jvolypeo
stui-screen__ft -> cx_xxqohiyj
next -> cx_upapeugr
stui-page__box -> cx_gclrkumm
logo -> cx_uzmlpche
desc -> cx_zlffnhem
flickity -> cx_vcltzpvx
flickity-item -> cx_zpnrvrqn
png -> cx_tnirtdlu
text-muted -> cx_fgpemvqq
share-weixin -> cx_egtsdrsx
color -> cx_zfrlnecj
stui-pannel-left -> cx_gcwplvrc
embed-responsive-4by3 -> cx_ybhzvptk
stui-content__ad -> cx_dedeknds
top -> cx_nktazzdp
flickity-enabled -> cx_mjtateje
visible-xs -> cx_uhslzpet
stui-header__logo -> cx_xqastdts
stui-link__text -> cx_donexjyp
hidden-sm -> cx_cxrmyylz
stui-pannel -> cx_qxoapjxq
form-control -> cx_pyjyiwzk
stui-content -> cx_spggcsia
shoutu -> cx_mwshlgmq
title -> cx_bbxkoftw
margin-0 -> cx_uajvdfin
pagego -> cx_wfvxeibf
row -> cx_vcrabmay
hidden-xs -> cx_jhjquqyl
stui-content__desc -> cx_lumtsjuf
left -> cx_vcdpolhj
top-fixed-up -> cx_nljhpvvw
previous -> cx_jomtfqsi
arrow -> cx_ehnvxkpk
col-pd -> cx_zuvcilnm
blue -> cx_kjcqrerf
pagelink_b -> cx_opggypri
open -> cx_xqygrgso
mac_results -> cx_welbhibn
embed-responsive-16by9 -> cx_joghjfue
icon_history -> cx_sxwiaiee
set -> cx_sclxievu
autocomplete-suggestion -> cx_xpymqbso
pagebtn -> cx_ekxrpqdz
no-svg -> cx_jzgrzuzc
overflow -> cx_kezzohnj
nonum -> cx_gfvomtme
stui-player__video -> cx_fasbzwtk
pull-left -> cx_kfiffxub
app -> cx_mufksaej
tab -> cx_ifznnxfs
top-fixed-down -> cx_pulgdoqz
stui-header__search -> cx_xaccugqr
15s -> cx_rncbhexg
icon_gbook -> cx_afxhcbcf
visible-md -> cx_wwseyycn
share-other -> cx_njtqetcn
pic -> cx_nsnnggbw
stui-content__thumb -> cx_cthhjxse
stui-vodlist__item -> cx_rokswbzo
page-item -> cx_qpolqghc
text-red -> cx_jwtknida
split-line -> cx_zyjcljfv
carousel-inner -> cx_eyfqdjwx
stui-header__hd -> cx_foeqyhbb
dropdown -> cx_xqfojqyl
embed-responsive -> cx_hkbtqcxo
stui-header__top -> cx_atmfsqry
stui-header__user -> cx_mthukcbu
text-center -> cx_qdqtkctd
screen-open -> cx_zcxvbqrx
pull-right -> cx_ahtwgegs
embed-responsive-item -> cx_ocaeuggm
com -> cx_qhktbmvw
5s -> cx_ljidtcbr
img-responsive -> cx_gpstvscg
play -> cx_qlwqfrea
is-pointer-down -> cx_hdqhnuxe
stui-vodlist__title -> cx_opvcqwmp
stui-vodlist__text -> cx_jriickrb
stui-vodlist__thumb -> cx_hobnutpv
history -> cx_ggroegjq
letter-list -> cx_ahylbuys
container -> cx_fnncqktw
